30 30
##############################
-                        #####
###### ########## #### #######
###### ########## #### #######
###### ##########      #######
######    ####################
######### ####################
######### ####################
#########    #################
############ #################
#                    #########
####### ########### ##########
####### ########### ##########
####### ########### ##########
#       ########### ##########
## ################ ##########
## ################ ##########
## #############    ##########
################ #############
##############               #
#              #  ######### ##
#### ##### #####  ####      ##
#### ##### ###### #### #### ##
#### ##### ###### #### ####  #
################# ############
###               ############
################# ############
#################            +
##############################
##############################