20 32
######-############
###### ######   # #
###### ###### # # #
######        # # #
############### # #
#########       # #
######### ####### #
######### ####### #
########    ##### #
#         # ##### #
###### #### ##### #
###### #### ##### #
######      ##### #
########### ##### #
###########       #
################# #
################# #
################# #
################# #
### ############# #
### ############# #
### ############# #
### #######       #
### ####### #######
### ####### #######
### ####### #######
### ####### #######
### ####### #######
###         #######
########### #######
########### #######
###########+#######