30 30
##############################
-      					 #####
###### ########## #### #######
###### ########## #### #######
###### ##########      #######
######    ####################
######### ####################
######### ####################
#########    #################
############ #################
#                    #########
####### ########### ##########
####### ########### ##########
####### ########### ##########
#       ########### ##########
## ################ ##########
## ################ ##########
## #############    ##########
################ #############
##############   			 #
#			   #  ######### ##
#### ##### #####  ####      ##
#### ##### ###### #### #### ##
#### ##### ###### #### ####  #
################# ############
###				  ############
################# ############
################# 			 +
##############################
##############################