25 25
######################+##
### #################  ##
###   ############### ###
##### ###############  ##
##### #######       ## ##
##### ####### ##### ## ##
##### ####### #####    ##
###        ## ###########
########## ## ###########
########## ## ###########
########## ## ###########
########## ## #####    ##
########## ## ##### #####
#    ##### ## ##### #####
#### #####          #####
#### #####     ##########
#### #####     ##########
#### #####     ##########
#### ##### ##############
###        ##############
### #### ################
### #### ################
### ####           ######
-   #####################
#########################
